#          B
###### #### 
# #       # 
# # ### # #  
#   #   # # 
##### ##### 
A     #     