### #B##
### # ##
###   ##
#### ###
#      #
#A######