##     ############
## ###  ###########
## #B   ###########
## ###    #########
##     ## #########
### ##### #########
###  ##   #########
####   A###########